NO ./path_to_the_north_texture
SO ./path_to_the_south_texture
WE ./path_to_the_west_texture
EA ./path_to_the_east_texture

F 220,100,0
C 225,30,0

4

1111111111111111111111111111111111
11111111111111111000000000000001
11000000000010001000000010000001
11000000000000000000000000100001
110000000000000010000001N000001
11111111111111111000000000000001
11000000000010001000000000000001
11000000000000000000000000000001
11000000000000001000000000000001
1111111111111111111111111111111111
